A	Устройство	Устройства
BA	Громкоговоритель	Громкоговорители
BB	Магнитострикционный элемент	Магнитострикционные элементы
BD	Детектор ионизирующих излучений	Детекторы ионизирующих излучений
BE	Сельсин-приемник	Сельсин-приемники
BF	Телефон	Телефоны
ВС	Сельсин-датчик	Сельсин-датчики
ВК	Тепловой/ые датчик	Тепловые датчики
BL	Фотоэлемент	Фотоэлементы
ВМ	Микрофон	Микрофоны
ВР	Датчик давления	Датчики давления
BQ	Пьезоэлемент	Пьезоэлементы
BR	Датчик частоты вращения	Датчики частоты вращения
BS	Звукосниматель	Звукосниматели
BV	Датчик скорости	Датчики скорости
C	Конденсатор	Конденсаторы
DA	Микросхема аналоговая	Микросхемы аналоговые
DD	Микросхема цифровая	Микросхемы цифровые
DS	Устройство хранения информации	Устройства хранения информации
DT	Устройство задержки	Устройства задержки
ЕK	Нагревательный элемент	Нагревательные элементы
EL	Лампа осветительная	Лампы осветительные
ЕТ	Пиропатрон	Пиропатроны
F	Устройство защитное	Устройства защитные
FA	Дискретный элемент защиты по току мгновенного действия	Дискретные элементы защиты по току мгновенного действия
FP	Дискретный элемент защиты по току инерционного действия	Дискретные элементы защиты по току инерционного действия
FU	Предохранитель	Предохранители
FV	Дискретный элемент защиты по напряжению	Дискретные элементы защиты по напряжению
G	Генератор	Генераторы
GB	Батарея	Батареи
H	Устройство индикационное и сигнальное	Устройства индикационные и сигнальные
НА	Прибор звуковой сигнализации	Приборы звуковые сигнализации
HG	Индикатор символьный	Индикаторы символьные
HL	Прибор световой сигнализации	Приборы световой сигнализации
K	Реле	Реле
KА	Реле токовое	Реле токовые
KН	Реле указательное	Реле указательные
KK	Реле электротепловое	Реле электротепловые
KМ	Контактор	Контакторы
KТ	Реле времени	Реле времени
KV	Реле напряжения	Реле напряжения
L	Катушка индуктивности	Катушки индуктивности
LL	Дроссель люминесцентного освещения	Дроссели люминесцентного освещения
М	Двигатель	Двигатели
Р	Прибор	Приборы
РА	Амперметр	Амперметры
PC	Счетчик импульсов	Счетчики импульсов
PF	Частотомер	Частотомеры
PI	Счетчик активной энергии	Счетчики активной энергии
РK	Счетчик реактивной энергии	Счетчики реактивной энергии
PR	Омметр	Омметры
PS	Регистрирующий прибор	Регистрирующие приборы
РТ	Часы	Часы
PV	Вольтметр	Вольтметры
PW	Ваттметр	Ваттметры
Q	Выключатель	Выключатели
QF	Выключатель автоматический	Выключатели автоматические
QK	Короткозамыкатель	Короткозамыкатели
QS	Разъединитель	Разъединители
R	Резистор	Резисторы
RK	Терморезистор	Терморезисторы
RP	Потенциометр	Потенциометры
RS	Шунт измерительный	Шунты измерительные
RU	Варистор	Варисторы
S	Устройство коммутационные в цепях управления	Устройства коммутационные в цепях управления
SA	Выключатель кнопочный	Выключатели кнопочные
SB	Переключатель	Переключатели
SF	Выключатель автоматический	Выключатели автоматические
Т	Трансформатор	Трансформаторы
ТА	Трансформатор тока	Трансформаторы тока
TS	Электромагнитный стабилизатор	Электромагнитные стабилизаторы
TV	Трансформатор напряжения	Трансформаторы напряжения
U	Устройство связи	Устройства связи
UB	Модулятор	Модуляторы
UR	Демодулятор	Демодуляторы
UI	Дискриминатор	Дискриминаторы
UZ	Преобразователь частотный	Преобразователи частотные
V	Прибор электровакуумный и полупроводниковый	Приборы электровакуумные и полупроводниковые
VD	Диод	Диоды
VL	Прибор электровакуумный	Приборы электровакуумные
VT	Транзистор	Транзисторы
VS	Тиристор	Тиристоры
W	Линиии элементы СВЧ	Линиии элементы СВЧ
WA	Антенна	Антенны
WE	Ответвитель	Ответвители
WK	Короткозамыкатель	Короткозамыкатели
WS	Вентиль	Вентили
WT	Трансформатор	Трансформаторы
WU	Аттенюатор	Аттенюаторы
X	Соединение контактное	Соединения контактные
XA	Токосъемник	Токосъемники
XP	Вилка	Вилки
XS	Розетка	Розетки
XT	Соединение разборное	Соединения разборные
XW	Соединитель высокочастотный	Соединители высокочастотные
Y	Устройство механические с электромагнитным приводом	Устройства механические с электромагнитным приводом
YA	Электромагнит	Электромагниты
YB	Тормоз с электромагнитным приводом	Тормоза с электромагнитным приводом
YC	Муфта с электромагнитным приводом	Муфты с электромагнитным приводом
YH	Электромагнитный патрон	Электромагнитные патроны
Z	Устройство оконечное фильтр	Устройства оконечные фильтр
ZL	Ограничитель	Ограничители
ZQ	Фильтр кварцевый	Фильтры кварцевые